1111111111111111
1000000P00000001
100000CC000E0001
100000CC00000001
1111111111111111
