11111
100E1
10P01
100C1
11111
