111111111111111
1P0C1C00E000011
1000100C0100001
100010000001001
110010001100001
111001001100001
100010000000001
101000010100001
100000001000001
110010000100011
101000010010001
100000000100001
100010010000101
100000000000001
111111111111111
